17 17 15 15 15 15 15 15 15 15 15 15 15 15 15 15 15 15 15 15 15 15 15 15 15 15 15 15 15 15 15 15 15 15 15 15 15 15 15 15 15 15 15 15 15 15 15 15 15 15 15 15 15 15 15 15 15 15 15 15
17 17 17 05 05 05 05 05 05 05 05 05 05 05 05 05 05 05 05 05 05 05 05 05 05 05 05 05 05 05 05 05 05 05 05 05 05 05 05 05 05 05 05 05 05 05 05 05 05 05 05 05 05 05 05 05 05 05 05 15
17 17 17 03 03 03 03 04 04 03 03 03 03 04 04 04 04 03 04 03 04 04 03 03 03 03 03 04 04 03 03 03 03 04 03 04 03 03 03 03 03 03 03 04 03 03 03 03 03 03 03 04 04 04 04 04 04 04 05 15
15 17 17 17 03 03 03 04 03 03 03 03 03 03 04 03 03 03 03 03 03 04 03 03 03 03 03 03 04 03 03 03 03 03 03 03 03 03 03 03 03 03 03 03 03 03 03 03 03 03 03 03 03 03 03 04 03 04 05 15
15 05 04 17 17 03 03 03 03 03 03 03 03 03 03 03 03 03 03 03 03 03 03 03 03 03 03 03 03 03 03 03 03 03 03 03 03 03 03 03 03 03 03 03 03 03 03 03 03 03 03 12 03 03 03 03 03 04 05 15
15 05 04 17 17 17 17 03 03 03 03 03 03 03 03 03 03 03 03 03 03 03 03 03 03 03 03 03 03 03 03 03 03 03 03 03 03 03 03 03 03 03 03 03 03 03 03 03 03 03 03 03 03 03 03 03 04 04 05 15
15 05 03 03 17 03 17 03 03 03 03 03 03 03 03 03 03 03 03 03 03 03 03 03 03 03 03 03 03 03 03 03 03 03 03 03 03 03 03 03 03 03 03 03 03 03 03 03 03 03 03 03 03 03 03 03 03 03 05 15
15 05 04 03 03 03 03 03 03 03 03 03 03 03 03 03 03 03 03 03 03 03 03 03 03 03 03 03 03 03 03 03 03 03 03 03 03 03 03 03 03 03 03 03 03 03 03 03 03 03 03 03 03 03 03 03 03 04 05 15
15 05 04 04 03 03 03 03 03 03 03 03 03 03 03 03 03 03 03 03 03 03 03 03 03 03 03 03 01 01 01 01 03 03 03 03 03 03 03 03 03 03 03 03 03 03 03 03 03 03 03 03 03 03 03 03 04 04 05 15
15 05 04 03 03 03 03 03 03 03 03 03 03 03 03 03 03 03 03 03 03 03 03 03 03 03 03 03 01 02 02 02 01 01 03 03 03 03 03 03 03 03 03 03 03 03 03 03 03 03 03 03 03 03 03 03 03 04 05 15
15 05 03 03 03 03 03 03 03 03 03 03 03 03 03 03 03 03 03 03 03 12 03 03 03 03 03 01 01 02 02 02 02 01 03 03 03 03 03 03 03 03 02 02 02 03 03 03 03 03 03 03 03 03 03 03 03 03 05 15
15 05 04 03 03 03 03 03 03 03 03 03 03 03 12 03 03 03 03 03 03 03 03 03 03 03 00 01 01 02 02 02 02 01 03 03 00 00 00 03 03 02 02 02 02 03 03 03 03 03 03 03 03 03 03 03 03 04 05 15
15 05 03 03 03 03 03 03 03 03 03 03 03 03 03 03 03 03 03 03 03 03 03 03 03 03 00 01 01 02 02 02 02 01 01 00 00 00 00 00 03 01 01 01 01 01 01 01 01 03 03 03 03 03 03 03 03 03 05 15
15 05 04 03 03 03 03 03 03 03 03 03 03 03 03 03 03 03 03 03 03 03 03 03 03 00 00 01 01 02 02 02 02 01 01 00 00 00 00 00 01 01 02 02 01 02 01 01 01 03 03 03 03 03 03 03 03 04 05 15
15 05 04 03 03 03 03 03 03 03 03 03 03 03 03 03 03 03 03 03 03 03 03 03 00 00 00 01 01 02 02 02 02 02 01 00 00 00 00 00 01 02 02 02 02 02 02 01 01 03 03 03 03 03 03 03 03 04 05 15
15 05 04 04 03 03 03 03 03 03 03 03 03 03 03 03 03 03 03 03 03 03 03 03 00 00 00 01 01 01 02 02 02 02 01 00 00 00 00 00 01 02 02 06 06 06 06 02 01 03 03 03 03 03 03 03 04 04 05 15
15 05 03 03 03 03 03 03 03 03 03 03 03 03 03 03 03 03 03 03 03 03 00 00 00 00 00 01 01 02 02 02 02 02 01 00 00 00 00 00 01 02 02 06 07 07 06 02 01 03 03 03 03 03 03 03 03 03 05 15
15 05 03 03 03 03 03 03 03 03 03 03 03 03 03 03 03 03 03 03 03 03 00 00 00 00 00 01 01 02 02 06 06 02 01 00 00 00 09 01 01 02 06 06 07 07 06 02 01 03 03 03 03 03 03 03 03 03 05 15
15 05 03 03 03 03 03 03 03 03 03 03 03 03 03 03 03 03 03 03 03 00 00 00 00 00 01 01 01 02 06 06 06 06 02 01 01 01 10 10 11 02 06 07 07 07 06 02 01 03 03 03 03 03 03 03 03 03 05 15
15 05 04 03 03 03 03 03 03 03 03 03 03 03 03 03 03 03 03 03 03 00 00 00 00 00 01 01 01 02 06 07 07 06 02 02 02 02 18 11 11 11 06 07 07 07 06 02 01 03 03 03 03 03 03 03 03 04 05 15
15 05 03 03 03 03 03 03 03 03 03 03 03 03 03 03 03 03 03 03 03 00 00 00 00 00 01 01 02 02 06 07 07 06 02 02 06 06 06 06 06 06 06 07 07 07 06 02 01 01 03 03 03 03 03 03 03 03 05 15
15 05 03 03 03 03 03 03 03 03 03 03 03 03 03 03 03 03 03 03 03 01 01 01 01 01 01 02 02 02 06 07 07 06 02 02 06 07 07 07 07 07 07 07 07 07 06 02 02 01 03 03 03 03 03 03 03 03 05 15
15 05 03 03 03 03 03 03 03 03 03 03 03 03 03 03 03 03 03 03 01 01 02 02 02 02 02 02 06 06 07 07 07 07 06 02 06 07 07 07 07 07 07 07 07 07 06 06 02 01 03 03 03 03 03 03 03 03 05 15
15 05 04 04 03 03 03 03 03 03 03 03 03 03 03 03 03 03 03 03 03 01 02 02 02 02 02 02 06 07 07 07 07 07 06 02 06 07 07 07 07 07 07 07 07 07 07 06 02 01 03 03 03 03 03 03 04 04 05 15
15 05 04 03 03 03 03 03 03 03 03 03 03 03 03 03 03 03 03 03 01 01 02 02 02 02 02 06 06 07 07 07 07 07 06 06 06 07 07 07 07 07 07 07 07 07 07 06 02 01 00 03 03 03 03 03 03 04 05 15
15 05 04 03 03 03 03 03 03 03 03 03 03 03 03 03 03 03 03 01 01 01 02 02 02 06 06 06 06 07 07 07 07 07 07 07 07 07 07 07 07 07 07 07 07 07 07 06 02 01 00 03 03 03 03 03 03 04 05 15
15 05 03 03 03 03 03 03 03 03 03 03 03 03 03 03 03 03 03 01 01 01 02 02 02 02 02 06 07 07 07 07 07 07 07 07 07 07 07 08 08 07 07 07 07 07 07 06 02 01 00 03 03 03 03 03 03 03 05 15
15 05 03 03 03 03 03 03 03 03 03 03 03 03 03 03 03 03 03 03 01 01 02 02 02 02 02 06 07 07 07 07 07 07 07 07 07 07 07 08 08 07 07 07 07 07 07 06 02 01 00 03 03 03 03 03 03 03 05 15
15 05 03 03 03 03 03 03 03 03 03 03 03 03 03 03 03 03 03 03 03 01 01 01 02 02 02 06 07 07 07 07 07 07 07 07 07 07 07 08 07 07 07 07 07 07 06 06 02 01 00 03 03 03 03 03 03 03 05 15
15 05 04 03 03 03 03 03 03 03 03 03 03 03 03 03 03 03 03 03 03 03 03 03 01 01 02 06 06 07 07 07 07 07 07 07 07 07 07 07 07 07 07 07 07 07 06 02 02 01 00 03 03 03 03 03 03 04 05 15
15 05 03 03 03 03 03 03 03 03 03 03 03 03 03 03 03 03 03 03 03 03 03 03 03 01 02 06 06 06 07 07 07 07 07 07 07 07 07 07 07 07 07 07 07 06 06 02 00 00 03 03 03 03 03 03 03 03 05 15
15 05 03 03 03 03 03 03 03 03 03 03 03 03 03 03 03 03 03 03 03 03 03 03 03 03 01 02 02 06 06 07 07 07 07 07 07 07 07 07 07 07 07 07 07 06 06 02 00 00 03 03 03 03 03 03 03 03 05 15
15 05 03 03 03 03 03 03 03 03 03 03 03 03 03 03 03 12 03 03 03 03 03 03 03 03 01 01 02 02 06 06 06 06 07 07 07 06 06 07 07 06 06 07 07 06 02 02 00 00 03 03 03 03 03 03 03 03 05 15
15 05 04 03 03 03 03 03 03 03 03 03 03 03 03 03 03 03 03 03 03 03 03 03 03 03 03 03 01 02 02 02 02 06 02 02 02 11 06 07 07 06 06 06 06 06 02 02 00 00 03 03 03 03 03 03 03 04 05 15
15 05 04 04 03 03 03 03 03 03 03 03 03 03 03 03 03 03 03 03 03 03 03 03 03 03 03 03 03 01 01 01 02 02 02 02 02 02 02 02 02 02 02 02 02 02 02 02 00 00 03 03 03 03 03 03 04 04 05 15
15 05 04 04 03 03 03 03 03 03 03 03 03 03 03 03 03 03 03 03 03 03 03 03 03 03 03 03 03 03 03 03 01 01 01 02 02 02 02 02 02 02 02 02 02 02 02 02 00 03 03 03 03 03 03 03 04 04 05 15
15 05 04 03 03 03 03 04 03 03 03 03 03 03 04 03 03 03 03 03 03 04 03 03 03 03 03 03 04 03 03 03 03 03 03 01 01 00 01 03 03 03 00 00 03 03 00 03 03 03 03 03 03 03 03 04 03 04 05 15
15 05 04 04 03 03 03 04 04 03 03 03 03 04 04 04 04 03 04 03 04 04 03 03 03 03 03 04 04 03 03 04 03 04 03 04 03 03 03 03 03 03 03 03 03 03 03 03 03 03 03 04 04 04 04 04 04 04 05 15
15 05 05 05 05 05 05 05 05 05 05 05 05 05 05 05 05 05 05 05 05 05 05 05 05 05 05 05 05 05 05 05 05 05 05 05 05 05 05 05 05 05 05 05 05 05 05 05 05 05 05 05 05 05 05 05 05 05 05 15
15 15 15 15 15 15 15 15 15 15 15 15 15 15 15 15 15 15 15 15 15 15 15 15 15 15 15 15 15 15 15 15 15 15 15 15 15 15 15 15 15 15 15 15 15 15 15 15 15 15 15 15 15 15 15 15 15 15 15 15




